






 
######################
#                    #
#                    #
_E               s   #
#                    #
######################