






 
######################
#                    #
#                    #
_                S   #
#                    #
######################