






 
######################
#                    #
#                    #
_@               S   #
#                    #
######################